T,z,z,z,T,T,T,T,T,T,T,z,z,z,z,D
T,z,z,z,z,z,z,z,z,z,z,z,z,z,z,D
T,z,z,z,z,z,z,z,z,z,z,z,z,z,z,D
T,z,z,z,z,z,z,z,z,z,z,z,z,z,z,D
T,z,z,z,z,A,A,A,A,A,z,z,z,z,z,D
T,z,z,z,z,z,z,z,z,z,z,z,z,z,z,D
T,z,z,z,A,A,A,A,A,A,A,z,z,z,z,D
T,z,z,z,z,z,z,z,z,z,z,z,z,z,z,D
T,z,z,z,A,A,A,A,A,A,A,z,z,z,z,D
T,z,z,z,T,T,T,T,T,T,T,z,z,z,z,D
T,z,z,z,T,T,T,T,T,T,T,z,z,j,o,D
T,z,z,z,T,T,T,T,T,T,T,z,z,Y,n,D
t,t,t,t,t,t,t,t,t,t,t,t,t,t,t,t
t,t,t,t,t,t,t,t,t,t,t,t,t,t,t,t
